######
#    #
# #a #
# bB #
# GB #
#    #
######